111111111111111111111111111111
100000000000000000000000000001
100000000000000000000000000001
100000000000000000000000000001
100000000000000000000000000001
100000000000000000000000000001
100000000000000000000000000001
100000000000000000000000000001
100000000000000000000000000001
100000003000000000000000000001
100000001000000000000000000001
100000000000001000001111000001
100000000000000000000000001001
100000000000000000000000000001
100000000000000000000000000011
100000000000000000000000000001
100000000000000000000000000001
111111110011110001000100000011
111111110011110001000100000011
111111110011110001000100000011