111111111111111111111111111111
100000000000000000000000000001
100000000000000000000000000001
100000000000000000000000000001
100000000000000000000000000001
100000000000000000010000000001
100000000000000000000000043001
100001100000010000000000041001
100000000000000000000000000001
101000000000000000000000000001
100410000000000000000010000001
101000000000000000000000000001
100000004440000000440000041001
111111111111110001110000000001
100000000000000000000000000011
100000000000000000000000100001
100000000004000000000000000001
111111110011110001000100000001
111111110011110001000100000001
111111110011110001000100000001