111111111111111111111111111111
100000000000000000000000000001
100000000000000000000000000001
100000000004000400040000400031
100000014411441144111441114411
100000000000000000000000000001
100000000000000000000000000001
111111110144144111111110000001
100000000000000000000000000011
100000000000000000000000000001
100000011111111111111111111111
100000000000000000000000000001
100000000000000000000000000001
111111111111110001110000000001
100000000000000000000000000011
100000000000000000000000100001
100000000000000000000000000001
111111111111110001111100000001
111111111111110001111100000001
111111111111110001111100000001