111111111111111111111111111111
100000000000000000000000000001
100000000000000000000000000001
100000000004000000001111111111
110100000111100100000000000001
110140404040404040404000000001
110100000000000000000000000001
110100000000000000000000104041
110100000000000000000000004041
110000000000000000000000104041
110000000000000000000000004041
111111111111111111111000004041
100000000000000000001000004041
100000000000000000001000004041
100000000000000000001000000001
100000000400000000001000000001
100000000000040000001000040001
110000000100040000001444410001
130000000100000000001000000401
111111111111110010001111111111