111111111111111111111111111111
100000001000000000000000000001
100000001000000000000000000001
100000041000000000000000000001
100000501000000000000000000001
111111111000000000000000000001
100000000000000000000000000001
100000000000000500000000000001
100000000000000100000000000001
100000000000000000000000000001
100000000000000000000000000001
100000000000000000000000000001
144444444400000000000000000001
111111111100000000000000000001
100000000100000000000000000001
100000000100000000000000000001
100000000100000000000455400001
100000000100000000000111100001
130000000100000000000000000001
111111100100000000000000000001
